NO ./textures/north.xpm
SO ./textures/south.xpm
WE ./textures/west.xpm
EA ./textures/east.xpm
DOOR ./textures/n.xpm
F 255,0,0
C 0,0,255

1111111
10W0D01
1000001
10000W1
1111111