NO ./textures/n.xpm
SO ./textures/s.xpm
WE ./textures/w.xpm
EA ./textures/e.xpm
F 3safdsafdsfg0,120,50
C 60,140,g0

1111111111111111111111111
10000000001100000000000001
1011000001110000000000001
1001000000000000000000001
111111111011000001110000111111111
100000000011000001110111111111111
11110111111111011100000010001
11110111111111011101010010001
11000000110101011100000010001
10000000000000001100000010001
10000000000000001101010010001
1100N00111010101111101111000111
11110111 111011 1101111010001
11111111 111111 111111111111